words	forms
sete	sete setet setets seter seta sete setet setets seter setene sete seta setas seter setene
stryk	stryk stryken strykens stryker strykene stryk stryket strykets stryk stryka stryk stryket strykets stryk strykene stryk stryket strykets stryk stryka
tavle	tavle tavlen tavlens tavler tavlene tavle tavla tavlas tavler tavlene tavle tavla tavlas tavler tavlene
etterforskning	etterforskning etterforskningen etterforskningens etterforskninger etterforskningene etterforskning etterforskninga etterforskningas etterforskninger etterforskningene etterforsking etterforskingen etterforskingens etterforskinger etterforskingene etterforsking etterforskinga etterforskingas etterforskinger etterforskingene
særforbund	særforbund særforbundet særforbundets særforbund særforbunda særforbund særforbundet særforbundets særforbund særforbundene særforbund særforbundet særforbundets særforbund særforbunda
kode	kode koden kodens koder kodene kode koden kodens kodar kodane
leilighet	leilighet leiligheten leilighetens leiligheter leilighetene leilighet leiligheta leilighetas leiligheter leilighetene
ørret	oerret ørret ørret ørret oerreten ørreten ørreten ørreten ørretens oerretens ørretens ørretens oerreter ørreter ørreter ørreter oerretene ørretene ørretene ørretene aure auren aurens aurer aurene
bit	bit biten bitens biter bitene bit biten bitens bit bitene bit biten bitens bitar bitane bit biten bitens bit bitane
rad	rad raden radens rader radene rad rada radas rader radene rad rada radas rader radene
bystyrerepresentant	bystyrerepresentant bystyrerepresentanten bystyrerepresentantens bystyrerepresentanter bystyrerepresentantene bystyrerepresentant bystyrerepresentanten bystyrerepresentantens bystyrerepresentantar bystyrerepresentantane
mening	mening meningen meningens meninger meningene mening meninga meningas meninger meningene meining meiningen meiningens meininger meiningene meining meininga meiningas meininger meiningene
mål	mål maal mål mål målet maalet målet målet målets målets maalets målets mål maal mål mål måla maala måla måla mål maal mål mål målet maalet målet målet målets målets maalets målets mål maal mål mål målene maalene målene målene mål maal mål mål målet maalet målet målet målets målets maalets målets mål maal mål mål måla maala måla måla
forhold	forhold forholdet forholdets forhold forholda forhold forholdet forholdets forhold forholdene forhold forholdet forholdets forhold forholda
kanal	kanal kanalen kanalens kanaler kanalene kanal kanalen kanalens kanalar kanalane
frakk	frakk frakken frakkens frakker frakkene frakk frakken frakkens frakkar frakkane
ris	ris risen risens riser risene ris risen risens risar risane
mappe	mappe mappen mappens mapper mappene mappe mappa mappas mapper mappene mappe mappa mappas mapper mappene
melk	melk melken melkens melker melkene melk melka melkas melker melkene mjoelk mjølk mjølk mjølk mjoelken mjølken mjølken mjølken mjølkens mjoelkens mjølkens mjølkens mjoelker mjølker mjølker mjølker mjoelkene mjølkene mjølkene mjølkene mjoelk mjølk mjølk mjølk mjoelka mjølka mjølka mjølka mjølkas mjoelkas mjølkas mjølkas mjoelker mjølker mjølker mjølker mjoelkene mjølkene mjølkene mjølkene
vindu	vindu vinduet vinduets vindu vindua vindu vinduet vinduets vinduer vindua vindu vinduet vinduets vindu vinduene vindu vinduet vinduets vinduer vinduene
katt	katt katten kattens katter kattene katt katten kattens kattar kattane
innstilling	innstilling innstillingen innstillingens innstillinger innstillingene innstilling innstillinga innstillingas innstillinger innstillingene innstilling innstillinga innstillingas innstillingar innstillingane
kreft	kreft kreften kreftens krefter kreftene kreft kreften kreftens kreftar kreftane
bank	bank banken bankens banker bankene bank banken bankens bankar bankane
tropp	tropp troppen troppens tropper troppene tropp troppen troppens troppar troppane
skjerm	skjerm skjermen skjermens skjermer skjermene skjerm skjermen skjermens skjermar skjermane
husrom	husrom husrommet husrommets husrom husromma husrom husrommet husrommets husrom husrommene husrom husrommet husrommets husrom husromma
leder	leder lederen lederens ledere lederne
virus	virus viruset virusets virus virusa virus viruset virusets virus virusene virus viruset virusets virus virusa
kjøpepress	kjoepepress kjøpepress kjøpepress kjøpepress kjoepepresset kjøpepresset kjøpepresset kjøpepresset kjøpepressets kjoepepressets kjøpepressets kjøpepressets kjoepepress kjøpepress kjøpepress kjøpepress kjoepepressa kjøpepressa kjøpepressa kjøpepressa kjoepepress kjøpepress kjøpepress kjøpepress kjoepepresset kjøpepresset kjøpepresset kjøpepresset kjøpepressets kjoepepressets kjøpepressets kjøpepressets kjoepepress kjøpepress kjøpepress kjøpepress kjoepepressene kjøpepressene kjøpepressene kjøpepressene kjoepepress kjøpepress kjøpepress kjøpepress kjoepepresset kjøpepresset kjøpepresset kjøpepresset kjøpepressets kjoepepressets kjøpepressets kjøpepressets kjoepepress kjøpepress kjøpepress kjøpepress kjoepepressa kjøpepressa kjøpepressa kjøpepressa
strøm	stroem strøm strøm strøm stroemmen strømmen strømmen strømmen strømmens stroemmens strømmens strømmens stroemmer strømmer strømmer strømmer stroemmene strømmene strømmene strømmene
kart	kart karten kartens karter kartene kart karten kartens kart kartene kart karten kartens kartar kartane
spill	spill spillet spillets spill spilla spill spillet spillets spill spillene spill spillet spillets spill spilla
bølge	boelge bølge bølge bølge boelgen bølgen bølgen bølgen bølgens boelgens bølgens bølgens boelger bølger bølger bølger boelgene bølgene bølgene bølgene boelge bølge bølge bølge boelga bølga bølga bølga bølgas boelgas bølgas bølgas boelger bølger bølger bølger boelgene bølgene bølgene bølgene
gress	gress gresset gressets gress gressa gress gresset gressets gress gressene gras graset grasets gras grasa gras graset grasets gras grasene
overflate	overflate overflaten overflatens overflater overflatene overflate overflata overflatas overflater overflatene overflate overflata overflatas overflater overflatene
kjemi	kjemi kjemien kjemiens kjemier kjemiene kjemi kjemien kjemiens kjemiar kjemiane
utakt	utakt utakten utaktens utakter utaktene utakt utakta utaktas utakter utaktene utakt utakta utaktas utakter utaktene
vert	vert verten vertens verter vertene vert verten vertens vertar vertane
data	data dataet dataets data dataene data dataet dataets data dataa
varsel	varsel varselet varselets varsel varsla varsel varselet varselets varsel varslene varsel varslet varslets varsler varsla varsel varslet varslets varsler varslene varsel varselet varselets varsel varsla
egg	egg eggen eggens egger eggene egg egga eggas egger eggene egg eggen eggens eggar eggane egg egga eggas egger eggene
driftsregnskap	driftsregnskap driftsregnskapet driftsregnskapets driftsregnskap driftsregnskapa driftsregnskap driftsregnskapet driftsregnskapets driftsregnskaper driftsregnskapa driftsregnskap driftsregnskapet driftsregnskapets driftsregnskap driftsregnskapene driftsregnskap driftsregnskapet driftsregnskapets driftsregnskaper driftsregnskapene
fil	fil filen filens filer filene fil fila filas filer filene fil fila filas filer filene
moment	moment momentet momentets moment momenta moment momentet momentets momenter momenta moment momentet momentets moment momentene moment momentet momentets momenter momentene moment momentet momentets moment momenta
pære	pære pære paere pære pæren pæren paeren pæren pærens pærens pærens paerens pærer pærer paerer pærer pærene pærene paerene pærene pære pære paere pære pæra pæra paera pæra pæras pæras pæras paeras pærer pærer paerer pærer pærene pærene paerene pærene pære pære paere pære pæra pæra paera pæra pæras pæras pæras paeras pærer pærer paerer pærer pærene pærene paerene pærene
stoff	stoff stoffet stoffets stoff stoffa stoff stoffet stoffets stoffer stoffa stoff stoffet stoffets stoff stoffene stoff stoffet stoffets stoffer stoffene stoff stoffet stoffets stoff stoffa
horisont	horisont horisonten horisontens horisonter horisontene horisont horisonten horisontens horisontar horisontane
kloakk	kloakk kloakken kloakkens kloakker kloakkene kloakk kloakken kloakkens kloakkar kloakkane
plattform	plattform plattformen plattformens plattformer plattformene plattform plattforma plattformas plattformer plattformene plattform plattforma plattformas plattformer plattformene
tro	tro troen troens troer troene tro troa troas troer troene tro troa troas troer trør trør trør troerne trørne trørne trørne
fane	fane fanen fanens faner fanene fane fana fanas faner fanene fane fana fanas faner fanene
fag	fag faget fagets fag faga fag faget fagets fag fagene fag faget fagets fag faga
tjener	tjener tjeneren tjenerens tjenere tjenerne
mus	mus musen musens mus musene mus musa musas mus musene mus musa musas mus musene mus musa musas myser mysene
kohort	kohort kohorten kohortens kohorter kohortene kohort kohorten kohortens kohortar kohortane
melding	melding meldingen meldingens meldinger meldingene melding meldinga meldingas meldinger meldingene melding meldinga meldingas meldingar meldingane
rådgiver	rådgiver raadgiver rådgiver rådgiver rådgiveren raadgiveren rådgiveren rådgiveren rådgiverens rådgiverens raadgiverens rådgiverens rådgivere raadgivere rådgivere rådgivere rådgiverne raadgiverne rådgiverne rådgiverne
lyng	lyng lyngen lyngens lynger lyngene lyng lyngen lyngens lyngar lyngane
terror	terror terroren terrorens terrorer terrorene terror terroren terrorens terrorar terrorane
test	test testen testens tester testene test testen testens testar testane
linse	linse linsen linsens linser linsene linse linsa linsas linser linsene linse linsa linsas linser linsene
virkelighet	virkelighet virkeligheten virkelighetens virkeligheter virkelighetene virkelighet virkeligheta virkelighetas virkeligheter virkelighetene
operasjon	operasjon operasjonen operasjonens operasjoner operasjonene operasjon operasjonen operasjonens operasjonar operasjonane
side	side siden sidens sider sidene side sida sidas sider sidene side sida sidas sider sidene
Syden	Syden syden
sky	sky skyen skyens skyer skyene sky skya skyas skyer skyene sky skya skyas skyer skyene
tendens	tendens tendensen tendensens tendenser tendensene tendens tendensen tendensens tendensar tendensane
storby	storby storbyen storbyens storbyer storbyene storby storbyen storbyens storbyar storbyane
fjær	fjær fjær fjaer fjær fjæren fjæren fjaeren fjæren fjærens fjærens fjærens fjaerens fjærer fjærer fjaerer fjærer fjærene fjærene fjaerene fjærene fjær fjær fjaer fjær fjæren fjæren fjaeren fjæren fjærens fjærens fjærens fjaerens fjær fjær fjaer fjær fjærene fjærene fjaerene fjærene fjær fjær fjaer fjær fjæra fjæra fjaera fjæra fjæras fjæras fjæras fjaeras fjærer fjærer fjaerer fjærer fjærene fjærene fjaerene fjærene fjær fjær fjaer fjær fjæra fjæra fjaera fjæra fjæras fjæras fjæras fjaeras fjær fjær fjaer fjær fjærene fjærene fjaerene fjærene fjoer fjør fjør fjør fjoeren fjøren fjøren fjøren fjørens fjoerens fjørens fjørens fjoerer fjører fjører fjører fjoerene fjørene fjørene fjørene fjoer fjør fjør fjør fjoeren fjøren fjøren fjøren fjørens fjoerens fjørens fjørens fjoer fjør fjør fjør fjoerene fjørene fjørene fjørene fjoer fjør fjør fjør fjoera fjøra fjøra fjøra fjøras fjoeras fjøras fjøras fjoerer fjører fjører fjører fjoerene fjørene fjørene fjørene fjoer fjør fjør fjør fjoera fjøra fjøra fjøra fjøras fjoeras fjøras fjøras fjoer fjør fjør fjør fjoerene fjørene fjørene fjørene
oppvarming	oppvarming oppvarmingen oppvarmingens oppvarminger oppvarmingene oppvarming oppvarminga oppvarmingas oppvarminger oppvarmingene oppvarming oppvarminga oppvarmingas oppvarmingar oppvarmingane
formiddagen	formiddag formiddagen formiddagens formiddager formiddagene
damp	damp dampen dampens damper dampene damp dampen dampens dampar dampane
papir	papir papiret papirets papir papira papir papiret papirets papirer papira papir papiret papirets papir papirene papir papiret papirets papirer papirene papir papiret papirets papir papira
landet	land landet landets land landa land landet landets land landene land landet landets land landa
anfektelse	anfektelse anfektelsen anfektelsens anfektelser anfektelsene
nett	nett nettet nettets nett netta nett nettet nettets nett nettene nett nettet nettets nett netta
rev	rev reven revens rever revene rev reven revens revar revane
idiot	idiot idioten idiotens idioter idiotene idiot idioten idiotens idiotar idiotane
tape	teip teipen teipens teiper teipene tape tapen tapens taper tapene teip teipen teipens teipar teipane tape tapen tapens tapar tapane
