words	forms
тупик	тупик тупики тупика тупиков тупику тупикам тупика тупиков тупиком тупиками тупике тупиках
итальянец	итальянец итальянцы итальянца итальянцев итальянцу итальянцам итальянца итальянцев итальянцем итальянцами итальянце итальянцах
тачка	тачка тачки тачки тачек тачке тачкам тачку тачки тачкой тачкою тачками тачке тачках
головка	головка головки головки головок головке головкам головку головки головкой головкою головками головке головках
центр	центр центры центра центров центру центрам центр центры центром центрами центре центрах
обоснование	обоснование обоснования обоснования обоснований обоснованию обоснованиям обоснование обоснования обоснованием обоснованиями обосновании обоснованиях
правда	правда правды правды правд правде правдам правду правды правдой правдою правдами правде правдах
формат	формат форматы формата форматов формату форматам формат форматы форматом форматами формате форматах
наволочка	наволочка наволочки наволочки наволочек наволочке наволочкам наволочку наволочки наволочкой наволочкою наволочками наволочке наволочках
чек	чек чеки чека чеков чеку чекам чек чеки чеком чеками чеке чеках
университет	университет университеты университета университетов университету университетам университет университеты университетом университетами университете университетах
связка	связка связки связки связок связке связкам связку связки связкой связкою связками связке связках
совершенство	совершенство совершенства совершенства совершенств совершенству совершенствам совершенство совершенства совершенством совершенствами совершенстве совершенствах
апостол	апостол апостолы апостола апостолов апостолу апостолам апостола апостолов апостолом апостолами апостоле апостолах
земля	земля земли земли земель земле землям землю земли землёй землей землёю землею землями земле землях
лечение	лечение лечения лечения лечений лечению лечениям лечение лечения лечением лечениями лечении лечениях
расчет	расчёт расчет расчёты расчеты расчёта расчета расчётов расчетов расчёту расчету расчётам расчетам расчёт расчет расчёты расчеты расчётом расчетом расчётами расчетами расчёте расчете расчётах расчетах
помощник	помощник помощники помощника помощников помощнику помощникам помощника помощников помощником помощниками помощнике помощниках
любовь	любовь любви любви любвей любви любвям любовь любви любовью любвями любви любвях
монстр	монстр монстры монстра монстров монстру монстрам монстра монстров монстром монстрами монстре монстрах
облако	облако облака облака облаков облаку облакам облако облака облаком облаками облаке облаках
полость	полость полости полости полостей полости полостям полость полости полостью полостями полости полостях
название	название названия названия названий названию названиям название названия названием названиями названии названиях
собрат	собрат собратья собрата собратьев собрату собратьям собрата собратьев собратом собратьями собрате собратьях
предательство	предательство предательства предательства предательств предательству предательствам предательство предательства предательством предательствами предательстве предательствах
прорыв	прорыв прорывы прорыва прорывов прорыву прорывам прорыв прорывы прорывом прорывами прорыве прорывах
верховье	верховье верховья верховья верховий верховьев верховью верховьям верховье верховья верховьем верховьями верховье верховьи верховьях
стипендия	стипендия стипендии стипендии стипендий стипендии стипендиям стипендию стипендии стипендией стипендиею стипендиями стипендии стипендиях
кабан	кабан кабаны кабана кабанов кабану кабанам кабана кабанов кабаном кабанами кабане кабанах
кулиса	кулиса кулисы кулисы кулис кулисе кулисам кулису кулисы кулисой кулисою кулисами кулисе кулисах
проникновение	проникновение проникновения проникновения проникновений проникновению проникновениям проникновение проникновения проникновением проникновениями проникновении проникновениях
блин	блин блины блина блинов блину блинам блин блины блином блинами блине блинах
прецедент	прецедент прецеденты прецедента прецедентов прецеденту прецедентам прецедент прецеденты прецедентом прецедентами прецеденте прецедентах
благодарность	благодарность благодарности благодарности благодарностей благодарности благодарностям благодарность благодарности благодарностью благодарностями благодарности благодарностях
заблуждение	заблуждение заблуждения заблуждения заблуждений заблуждению заблуждениям заблуждение заблуждения заблуждением заблуждениями заблуждении заблуждениях
эшелон	эшелон эшелоны эшелона эшелонов эшелону эшелонам эшелон эшелоны эшелоном эшелонами эшелоне эшелонах
бригада	бригада бригады бригады бригад бригаде бригадам бригаду бригады бригадой бригадою бригадами бригаде бригадах
вызов	вызов вызовы вызова вызовов вызову вызовам вызов вызовы вызовом вызовами вызове вызовах
ядро	ядро ядра ядра ядер ядру ядрам ядро ядра ядром ядрами ядре ядрах
любовник	любовник любовники любовника любовников любовнику любовникам любовника любовников любовником любовниками любовнике любовниках
риторика	риторика риторики риторики риторик риторике риторикам риторику риторики риторикой риторикою риториками риторике риториках
пафос	пафос пафосы пафоса пафосов пафосу пафосам пафос пафосы пафосом пафосами пафосе пафосах
брат	брат братья браты брата братьев братов брату братьям братам брата братьев братов братом братьями братами брате братьях братах
четверть	четверть четверти четверти четвертей четверти четвертям четверть четверти четвертью четвертями четверти четвертях
авторитет	авторитет авторитеты авторитета авторитетов авторитету авторитетам авторитет авторитеты авторитетом авторитетами авторитете авторитетах
список	список списки списка списков списку спискам список списки списком списками списке списках
план	план планы плана планов плану планам план планы планом планами плане планах
поколение	поколение поколения поколения поколений поколению поколениям поколение поколения поколением поколениями поколении поколениях
ранец	ранец ранцы ранца ранцев ранцу ранцам ранец ранцы ранцем ранцами ранце ранцах
понедельник	понедельник понедельники понедельника понедельников понедельнику понедельникам понедельник понедельники понедельником понедельниками понедельнике понедельниках
маньяк	маньяк маньяки маньяка маньяков маньяку маньякам маньяка маньяков маньяком маньяками маньяке маньяках
советчик	советчик советчики советчика советчиков советчику советчикам советчика советчиков советчиком советчиками советчике советчиках
грех	грех грехи греха грехов греху грехам грех грехи грехом грехами грехе грехах
хрен	хрен хрены хрена хренов хрену хренам хрен хрены хреном хренами хрене хренах
уклад	уклад уклады уклада укладов укладу укладам уклад уклады укладом укладами укладе укладах
размышление	размышление размышления размышления размышлений размышлению размышлениям размышление размышления размышлением размышлениями размышлении размышлениях
железо	железо железа железа желез железу железам железо железа железом железами железе железах
блондин	блондин блондины блондина блондинов блондину блондинам блондина блондинов блондином блондинами блондине блондинах
веер	веер веера веера вееров вееру веерам веер веера веером веерами веере веерах
полукруг	полукруг полукруги полукруга полукругов полукругу полукругам полукруг полукруги полукругом полукругами полукруге полукругах
ссылка	ссылка ссылки ссылки ссылок ссылке ссылкам ссылку ссылки ссылкой ссылкою ссылками ссылке ссылках
жесть	жесть жести жести жестей жести жестям жесть жести жестью жестями жести жестях
штаб	штаб штабы штаба штабов штабу штабам штаб штабы штабом штабами штабе штабах
писк	писк писки писка писков писку пискам писк писки писком писками писке писках
углеводород	углеводород углеводороды углеводорода углеводородов углеводороду углеводородам углеводород углеводороды углеводородом углеводородами углеводороде углеводородах
роспись	роспись росписи росписи росписей росписи росписям роспись росписи росписью росписями росписи росписях
дядька	дядька дядьки дядьки дядек дядьке дядькам дядьку дядек дядькой дядькою дядьками дядьке дядьках
пролетарий	пролетарий пролетарии пролетария пролетариев пролетарию пролетариям пролетария пролетариев пролетарием пролетариями пролетарии пролетариях
формула	формула формулы формулы формул формуле формулам формулу формулы формулой формулою формулами формуле формулах
хозяйка	хозяйка хозяйки хозяйки хозяек хозяйке хозяйкам хозяйку хозяек хозяйкой хозяйкою хозяйками хозяйке хозяйках
фаворит	фаворит фавориты фаворита фаворитов фавориту фаворитам фаворита фаворитов фаворитом фаворитами фаворите фаворитах
увольнение	увольнение увольнения увольнения увольнений увольнению увольнениям увольнение увольнения увольнением увольнениями увольнении увольнениях
ясли	ясли яслей яслям ясли яслями яслях
промышленность	промышленность промышленности промышленности промышленностей промышленности промышленностям промышленность промышленности промышленностью промышленностями промышленности промышленностях
стол	стол столы стола столов столу столам стол столы столом столами столе столах
сверстник	сверстник сверстники сверстника сверстников сверстнику сверстникам сверстника сверстников сверстником сверстниками сверстнике сверстниках
закладка	закладка закладки закладки закладок закладке закладкам закладку закладки закладкой закладкою закладками закладке закладках
дух	дух духи духа духов духу духам дух духи духом духами духе духах
локоть	локоть локти локтя локтей локтю локтям локоть локти локтем локтями локте локтях
наложение	наложение наложения наложения наложений наложению наложениям наложение наложения наложением наложениями наложении наложениях
спутник	спутник спутники спутника спутников спутнику спутникам спутник спутники спутником спутниками спутнике спутниках
дядя	дядя дяди дяди дядей дяде дядям дядю дядей дядей дядею дядями дяде дядях
карман	карман карманы кармана карманов карману карманам карман карманы карманом карманами кармане карманах
лох	лох лохи лоха лохов лоху лохам лох лохи лохом лохами лохе лохах
юбилей	юбилей юбилеи юбилея юбилеев юбилею юбилеям юбилей юбилеи юбилеем юбилеями юбилее юбилеях
частица	частица частицы частицы частиц частице частицам частицу частицы частицей частицею частицами частице частицах
огонь	огонь огни огня огней огню огням огонь огни огнём огнем огнями огне огнях
цифра	цифра цифры цифры цифр цифре цифрам цифру цифры цифрой цифрою цифрами цифре цифрах
путь	путь пути пути путей пути путям путь пути путём путем путями пути путях
завод	завод заводы завода заводов заводу заводам завод заводы заводом заводами заводе заводах
цензура	цензура цензуры цензуры цензур цензуре цензурам цензуру цензуры цензурой цензурою цензурами цензуре цензурах
век	век века века веков веку векам век века веком веками веке веках
половинка	половинка половинки половинки половинок половинке половинкам половинку половинки половинкой половинкою половинками половинке половинках
живот	живот животы живота животов животу животам живот животы животом животами животе животах
удобство	удобство удобства удобства удобств удобству удобствам удобство удобства удобством удобствами удобстве удобствах
крушение	крушение крушения крушения крушений крушению крушениям крушение крушения крушением крушениями крушении крушениях
стена	стена стены стены стен стене стенам стену стены стеной стеною стенами стене стенах
крыша	крыша крыши крыши крыш крыше крышам крышу крыши крышей крышею крышами крыше крышах
полоса	полоса полосы полосы полос полосе полосам полосу полосы полосой полосою полосами полосе полосах
возраст	возраст возрасты возраста возрастов возрасту возрастам возраст возрасты возрастом возрастами возрасте возрастах
поставщик	поставщик поставщики поставщика поставщиков поставщику поставщикам поставщика поставщиков поставщиком поставщиками поставщике поставщиках
амбиция	амбиция амбиции амбиции амбиций амбиции амбициям амбицию амбиции амбицией амбициею амбициями амбиции амбициях
лишение	лишение лишения лишения лишений лишению лишениям лишение лишения лишением лишениями лишении лишениях
издательство	издательство издательства издательства издательств издательству издательствам издательство издательства издательством издательствами издательстве издательствах
линейка	линейка линейки линейки линеек линейке линейкам линейку линейки линейкой линейкою линейками линейке линейках
хор	хор хоры хора хоров хору хорам хор хоры хором хорами хоре хорах
установление	установление установления установления установлений установлению установлениям установление установления установлением установлениями установлении установлениях
поэзия	поэзия поэзии поэзии поэзий поэзии поэзиям поэзию поэзии поэзией поэзиею поэзиями поэзии поэзиях
союзник	союзник союзники союзника союзников союзнику союзникам союзника союзников союзником союзниками союзнике союзниках
памятник	памятник памятники памятника памятников памятнику памятникам памятник памятники памятником памятниками памятнике памятниках
радикал	радикал радикалы радикала радикалов радикалу радикалам радикал радикалы радикалом радикалами радикале радикалах
